:static:town
5197 5196 5197 5196 5197 5196 5197 5196 5197 5196 5197 5196 5197 5196 5197 5196 5197 5196 5197 5196 5197 5196 5197 5196 5197 5196 5197 5196 5197 5196 
5109 5108 5109 5108 5109 5108 5109 5108 5109 5108 5109 5108 5109 5108 5109 5108 5109 5108 5109 5108 5109 5108 5109 5108 5109 5108 5109 5108 5109 5108 
5197 5196 5197 5196 5197 5196 5197 5284 5285 5284 5285 5284 5285 5284 5287 5284 5287 5286 5285 5284 5285 5284 5285 5196 5197 5196 5197 5196 5197 5196 
5109 5108 5109 5108 5109 5108 5109 0001 0001 0001 0001 0001 0001 0001 0001 0001 0001 0001 0001 0001 0001 0001 0001 5108 5109 5108 5109 5108 5109 5108 
5197 5196 5197 5196 5197 5284 5287 0001 0001 0001 0001 0001 0001 0001 0001 0001 0001 0001 0001 0001 0001 0001 0001 5286 5285 5196 5197 5196 5197 5196 
5109 5108 5109 5108 5109 0001 0001 0104 0105 0105 0105 0106 0001 0001 0001 0001 0001 0001 0104 0105 0105 0105 0106 0001 0001 5108 5109 5108 5109 5108 
5197 5196 5197 5196 5197 0001 0001 0192 0193 0193 0193 0194 0001 0001 0001 0001 0001 0001 0192 0193 0193 0193 0194 0001 0001 5196 5197 5196 5197 5196 
5109 5108 5109 5108 5109 0001 0001 0280 0281 0281 0281 0282 0001 0001 0001 0001 0001 0001 0280 0281 0281 0281 0282 0001 0001 5108 5109 5108 5109 5108 
5197 5196 5197 5196 5197 0001 0001 0370 0546 0544 3592 0369 0001 0001 0001 0001 0001 0001 0368 3592 0545 0546 0371 0001 3504 5196 5197 5196 5197 5196 
5109 5108 5109 5108 5109 3504 0001 0458 0634 0632 3680 0457 0003 0001 0001 0001 0001 0003 0456 3680 0633 0634 0459 3504 0001 5108 5109 5108 5109 5108 
5197 5196 5197 5196 5197 0001 3504 0001 0001 0001 0017 0001 0001 0001 0001 0001 0001 0001 0001 0017 0001 0001 0001 0001 3504 5196 5197 5196 5197 5196 
5109 5108 5109 5108 5109 3504 0001 0001 3504 0001 0001 0001 0001 0001 0001 0001 0001 0001 0001 0001 0001 3504 0001 3504 0001 5108 5109 5108 5109 5108 
5197 5196 5197 5196 5197 0001 0001 0001 0001 0001 0001 0001 0001 0001 0001 0001 0001 0001 0001 0001 0001 0001 0001 0001 0001 5196 5197 5196 5197 5196 
5109 5108 5109 5108 5109 0001 0001 0001 0108 0722 0723 0109 0109 0109 0110 0001 0001 0001 0001 0001 0001 0001 0001 0001 0001 5108 5109 5108 5109 5108 
5197 5196 5197 5196 5197 0001 0001 0001 0196 0810 0811 0197 0197 0197 0198 0001 0001 0001 0001 0001 0003 0001 0001 0001 0001 5196 5197 5196 5197 5196 
5109 5108 5109 5108 5109 0001 0001 0001 0196 0197 0197 0197 0197 0197 0198 0001 0001 0001 0001 0001 0001 0001 0001 0001 0001 5108 5109 5108 5109 5108 
5197 5196 5197 5196 5197 0001 0001 0001 0286 0111 0111 0460 3768 0461 0287 0001 0001 0001 0001 0001 0001 0001 0001 5022 5023 5196 5197 5196 5197 5196 
5109 5108 5109 5108 5109 0001 0001 0001 0374 0199 0199 0548 3856 0549 0375 0001 0001 0001 0001 0001 0001 0001 0001 5110 5109 5108 5109 5108 5109 5108 
5197 5196 5197 5196 5197 5022 5023 0001 3504 3504 3504 0003 0017 0001 0001 0001 0001 0001 0001 0001 0001 5022 5023 5196 5197 5196 5197 5196 5197 5196 
5109 5108 5109 5108 5109 5108 5111 0001 3504 3504 3504 0001 0001 0001 0001 0001 0001 0001 0001 0001 0001 5110 5109 5108 5109 5108 5109 5108 5109 5108 
5197 5196 5197 5196 5197 5196 5197 5022 5023 5022 5023 5022 5023 5022 5023 5022 5023 5022 5023 5022 5023 5196 5197 5196 5197 5196 5197 5196 5197 5196 
5109 5108 5109 5108 5109 5108 5109 5108 5109 5108 5109 5108 5109 5108 5109 5108 5109 5108 5109 5108 5109 5108 5109 5108 5109 5108 5109 5108 5109 5108 
5197 5196 5197 5196 5197 5196 5197 5196 5197 5196 5197 5196 5197 5196 5197 5196 5197 5196 5197 5196 5197 5196 5197 5196 5197 5196 5197 5196 5197 5196 
5109 5108 5109 5108 5109 5108 5109 5108 5109 5108 5109 5108 5109 5108 5109 5108 5109 5108 5109 5108 5109 5108 5109 5108 5109 5108 5109 5108 5109 5108 
5197 5196 5197 5196 5197 5196 5197 5196 5197 5196 5197 5196 5197 5196 5197 5196 5197 5196 5197 5196 5197 5196 5197 5196 5197 5196 5197 5196 5197 5196 

:static:lab
06528 06529 06336 06530 06531 06336 06336 06337 06337 06336 06336 06336 06336 
06720 06721 07492 06722 06723 06338 06339 06340 06341 06342 06338 06338 06338 
06912 06913 07684 06914 06915 07494 06914 06915 06914 06915 07494 09794 09794 
07104 06146 06146 06146 07681 06146 06146 06146 06146 07105 07490 06146 07298 
06148 06146 06146 06146 06146 06146 06146 06146 06146 07104 07682 06146 06146 
06916 06917 07302 06917 06146 06146 06146 06146 06146 07495 07495 06146 06146 
07108 07109 07108 07109 06146 06146 06146 06146 06146 06146 06532 06533 06534 
07300 07301 07300 07301 06146 06146 06146 06146 06146 06146 06724 06725 06726 
07493 07494 07494 07494 06146 06146 06146 06146 06146 06146 07687 07495 09602 
06148 07296 06146 06146 06146 06146 06146 06146 06146 06146 06146 07491 07110 
07872 07488 07489 06146 06146 06146 06146 06146 06146 06146 07873 07683 07490 
07872 07680 06146 06918 06146 06146 06146 06146 06146 06146 06146 07875 07682 
07879 07495 06146 07110 06146 06146 06150 06151 06146 06146 06146 07495 07495 

:static:houseA_1
06336 06336 06734 06336 06336 06734 06734 06351 00000 00000 00000 
07304 07305 07306 07307 07308 06926 06926 06344 06345 06346 06350 
07496 07497 07498 07499 07500 06157 06157 06536 06537 06538 06542 
06156 06157 06157 06157 07690 06153 06153 08460 06157 06159 06157 
06156 06153 07688 07689 00622 06153 06153 06153 06153 06153 06153 
06156 07309 07880 07881 07882 07118 07310 06153 06153 06153 06153 
06156 06728 06729 06730 06731 06732 06733 06153 06153 06153 06153 
06156 06728 06729 06922 06923 06732 06733 06153 06153 06153 06153 
06156 07112 07113 07113 07113 07113 07117 06153 06154 06155 06153 

:static:houseA_2
08074 06336 08072 06336 08078 09231 06347 06345 06346 
08266 08267 08077 08461 00622 09423 06539 06540 06538 
08458 08459 09032 08462 08269 09032 06158 06157 06159 
09035 09036 09037 06153 09800 09801 09801 09802 06153 
09227 09228 09229 06153 06728 09993 09993 06733 06153 
09419 09420 09421 06153 06728 09993 09993 06733 06153 
06156 06153 06153 06153 07112 07113 07113 07117 06153 
06156 06153 06153 06153 06153 06153 06153 06153 06153 

:static:houseB_1
00000 00000 00000 06543 06734 06734 06336 06336 06336 06734 06336 
06336 06347 06345 08653 06926 06926 07691 07692 07305 07306 07304 
08268 06539 06537 08845 09032 06157 07883 07884 07497 07498 07496 
06156 06158 06157 06159 09033 06153 07694 06157 06157 06157 06157 
06156 06153 06153 06153 06153 06153 00622 07688 07689 06153 06153 
06156 06153 06153 06153 10376 10568 10379 10377 10378 10571 06153 
06156 06153 06153 06153 09995 10760 10569 10570 10763 09997 06153 
06156 06153 06153 06153 09995 10760 10761 10762 10763 09997 06153 
06156 06154 06155 06153 10187 10188 10188 10188 10188 10189 06153 


:static:houseB_2
06344 06345 06346 06927 08078 06336 08072 06336 08073 
06536 06540 06538 07119 00622 08079 08077 08264 08265 
07693 06157 06159 06157 08269 08463 06157 08456 08457 
06156 09803 09804 09804 09805 06153 09224 09036 09037 
06156 09995 09996 09996 09997 06153 09416 09417 09418 
06156 09995 09996 09996 09997 06153 09608 09420 09421 
06156 10187 10188 10188 10189 06153 06153 06153 06153 
06156 06153 06153 06153 06153 06153 06153 06153 06153 
